


NO ./xpm/north_texture.xpm



SO ./xpm/south_texture.xpm      
WE ./xpm/west_texture.xpm     
EA ./xpm/east_texture.xpm

F 121, 112, 112
C 57, 144, 200


111111111111111111111
1000000000000000001 1
110000001110000000011
110000011  11000001 1
1100000001100000001 1
101000W000011100001 1
111111111111111111111
