


NO ./xpm/north_texture.xpm



SO ./xpm/south_texture.xpm      
WE ./xpm/west_texture.xpm     
EA ./xpm/east_texture.xpm

F 121, 112, 112
C 57, 144, 200


1111111111111111111111111111111111111
1000000000000000000000000000000000001
1000000001111110000011111110000000001
100000001      10001       1000000011
1000000001111110000011111110000000001
1100000010000000000000000000000000001
11000000000000000N0000000000000000001
1100000000000000000000000000000000001
1100000000000000000000000000000000001
1111111111111111111111111111111111111
